
111111111
100000001
110000001
100000001 1111111
11111011100000001
10000000000001111
10000000N0001
1000000000001111
1000000000001
1000000000001
1000000000001
1100000111001
11110111 1101
11111111 1111
