111111111111111111111111111111111
        1000000000000000000000001
        110000000000W000000000001
        1000000000000000000000001
111111111000000000000000000000001
100000000000000000000000000001111
10000000001111111100000000001
10000000001      1000000000001
10000000001111111100000000001
10000000000000000000000000001
100000000000000000010100000011111111111111111111111
110000011101010111110111101000000000000000000000001
11110111 1110111 1011110100011111111111111111111111
11111111 1111111 111111111111

11111111111
10000000001
11111111111