111111111
111100N01
111111111

111111111
100000001
11111111111




