111111111
11000W001
111111111
