NO ./images/NO.xpm
SO ./images/SO.xpm
WE ./images/WE.xpm
EA ./images/EA.xpm
F 110,153,15 
C 255,255,255
1111111111111111111111111111111111
11111111111000000000000000000000001
1E11111111111111111111111111111111
1    111111000000000000000000000001
1111111111000000000000000111111111
111111111000000000000000000000001
100000000000000000000000000001111
10000000000000010000000000001
10000000000000000000000000001
10000000000000000000000000001
10000000000000000000000000001
10000000000000000001010000001
11000001110101011111011110101
11110111 1110111 101111010001
11111111 1111111 111111111111
